+--+--+--+--+--+
|     |  |     |
+  +  +  +  +  +
|  |  |  |  |  |
+--+  +  +  +  +
|     |  |  |  |
+  +--+  +  +  +
|        |  |  |
+  +--+--+  +  +
|           | g|
+--+--+--+--+--+